0000000000000000000000000000000000000000000000000000000000000000000000000000000000000000000000000000000000000000000000000000000000000000
0000000000000000000000000111000000000000000000000000000000000000000000000000000000000000000000000000000000000000000000000000000000000000
0000000000000000002000111111020000000000000000000000000000000000000000000000000000000000000000000000000000000000000000000000000000000000
0000000000000000000111111111000000000000000000000000000000000000000000000000000000000001111111110200000000000000000000000000000000000000
0000000000000000111111111111000000000000000000000000000000000000000000000000000000001111111111110000000000000000000000000000000000000000
0000000000400111111111111111100002000000000111111111111110000220000000000000000400111111111111111100000022000022000111111111000000000000
1111111111111111111111111111111111110011111111111111111111111001111011111111111111111111111111111111111100111100111111111111111110011110
