0000000000000000000000000000000000000000000000000000000000000000000000000000000000000000000000000000000000444444444444444444444444444444444444
0000000000000000000000000000000000000000000000000000000000000000000000000000000000000000000000000000000000222222222222222222222222222222222222
0000000000000000000000000000000000000000000000000000000000000000000000000000000000000000000000000000000000000000000000000000000000000000000000
0000000000000000000000000000000000000000000000000000000000000011111000000000000000000000000000000000000000000000000000000000000000000000000000
0000000000000000000000000000000000000000000000000000000000000000000222222220000000000111111100000000000000000000111111000111111100000000000000
0000000001110000000000000000000000000111111111111111111111111111111111111114440000000022200000111111000000111111111111000000000000000000000000
1111111111111111111111111111111111111221144111111111111111111111111111111111111111111111111111111111111111000000000000001111111111111111111111
