000000000000000000000000000022000000000000000000000000000000000000000000000000000000000000000000000000000000000000000000000000000000000000000000000000000000000000000000000000000000000000000000000000000000000000000000000000000000000000000000000000000000000000000000000000000000000000000000000000000000000000000000000000000000000
000000000000000000000000011100000000000000000000000000000000000000000000000000000000000000000000000000000000000000000000000000000000000000000000000000000000000000000000000000000000000000000000000000000000000000000000000000000000000000000000000000000000000000000000000000000000000000000000000000000000000111000000000000000000000
000000000000000000000011111100000000000000000000000000000000000000000000000000000000000000000000000000000000000000000000000000000000000000000000000000000000000000000000000000000000000000000000000000000000000000000000000000000000000000000000000000000000000000000000000000000000000000000000000000000000111111000000000000000000000
000000000000000000011111111100000000000000000000000000000000000000000000000000000002002111111111000000000000000000000000000000000000000000000000000000000000000000000000000000000000000000000000000020111110000000000000000000000000000000000000000000000000002220000000000000000000000000000000000000000111111111000000000000000000000
000000000000000011111111111100000000000000000000000000000000000000000000000000000000111111111111000000000000000000000000000000000000000000000000000000000000000000000000000000000000000000000000000000000000000000000000000201111111000000000000000000001111110001111111000000000000000000000000000000111111111111000000000000000000000
000000000000011111111111111110000000220000011111111111111000000000000000000000000011111111111111110000000000000000211111111100000000000000000000211100000000000000000000000001111111111111111111111111111111111111100000000000000000001111110000001111111111110000000000000000000000000000000000000111111111111111100000000000000111111
111111111111111111111111111111111111001111111111111111111111100111101111111111111111111111111111111111110011110011111111111111111001111011111111111111111111111111111111111110011001111111111111111111111111111111111111111111111111111111111111110000000000000011111111111111111111111111111111111111111111111111111111110011111111111
